ID,XP,HP,ATK,DEF,SPATK,SPDEF,Move1,Move2,Move3,Move4
0016,10,0,0,0,0,0,0000,0000,0000,0000
0025,10,0,0,0,0,0,0000,0000,0000,0000
0102,10,0,0,0,0,0,0000,0000,0000,0000
0191,10,0,0,0,0,0,0000,0000,0000,0000
0293,10,0,0,0,0,0,0000,0000,0000,0000
0425,10,0,0,0,0,0,0000,0000,0000,0000
